a --> K 
b --> H 
c --> I 
d --> N 
e --> O 
f --> L 
g --> M 
h --> B 
i --> C 
j --> @ 
k --> A 
l --> F 
m --> G 
n --> D 
o --> E 
p --> Z 
q --> [ 
r --> X 
s --> Y 
t --> ^ 
u --> _ 
v --> \ 
w --> ] 
x --> R 
y --> S 
z --> P 
A --> k 
B --> h 
C --> i 
D --> n 
E --> o 
F --> l 
G --> m 
H --> b 
I --> c 
J --> ` 
K --> a 
L --> f 
M --> g 
N --> d 
O --> e 
P --> z 
Q --> { 
R --> x 
S --> y 
T --> ~ 
U -->  
V --> | 
W --> } 
X --> r 
Y --> s 
Z --> p 
ÿ --> Õ 
